                                                                                                                                                                                                                                                                                                                                                                                           
                                                                                                                                                                                                                                                                                                                       W                                                                   
                                                                                                                                                                                                                                                                                                                      W W                                                                  
                                                                                                                                                                                                                                                                                                                     W   W                                                                 
                                                                                                            W                                                                                                                                                                                            WWWWWWWWWWWWWWWWWWWWWWWWWWWW                                                      
                                                                                                            W                                                                                                                                                                                              W       W       W      W                                                        
                                                                                                            W                                                                                                         0 0 0              0 0 0           0                                                   W    W         W   W                                                          
                                                                                                          WWWWW                                                                                                     XXXXXXXXXXXXXXX    XXXXXXXXXXXXXXXXXXXXXXXX                                                W W           WW                                                            
                                                                                         0    0 0 0         W                                                                                                                                                                                                   WW          W W                                                            
                                                      W                                 0     XXXXXXXXXXXXXXXX  0                                                                                 XXXXXXXXXXXXX                                                                                                 W W       W    W                                                           
                                                      W                   0  0  0     0       XXXXXXXXXXXXXXXXXXXXXXXXXXXXXX                                                       XXXXXXXXXXXXXX                                                                                                              W    W   W       W                                                          
                                                     WWW              XXXXXXXXXXXXXXXXXXXXXXXX                                     0                                                                                                                                                                          W       W         W                                                          
                                                      W                                                       0 0                                                                 0                                                                                                                         W      W   W        W                                                         
                                               XXXXXXXXXXXXXXXX                                                 XXXXXXXXXXXX                                           XXXXXXXXXXXXX        XXXXX                               0 0                                                                        W     W        W     W                                                         
                                               XXXXXXXXXXXXXXXX                0 0 0                            XXXXXXXXXXXX                             XXXXXXXXXXXXXXXXXXXXXXXXXXX             XXXXXXXX        0              XXXXX                  0        0                                          W    W            W   W                                                         
XXXXXXXXXXXXXXXXXXXXXXXXXXXXXXXXXXXXXXXXXXXXXXXXXXXXXXXXXXXXXXXXXXXXXXXXXXXXXXXXXXXXXXXXXXXXXXXXX    0 0 0      XXXXXXXXXXXXXXXXXXXXXXXXXXXXXXXXXXXXXXXXXXXXXXXXXXXXXXXXXXXXXXXXXXXXXXXXXXXXXXXXXXXXXXXXXXXXXXXXXXXXXXXXXXXXXXXXXXXXXX           XXXXXXXXXXXXXXXXXXXXXXXXXXXXXXXXXXXXXXXXXXXXXXXXXXXXXXXXXXXWWWXXXXXXXXXXXXXXXWXWXXXXXXXXXXXXXXXXXXXXXXXXXXXXXXXXXXXXXXXXXXXXXXXXXXXXXXXXXX
XXXXXXXXXXXXXXXXXXXXXXXXXXXXXXXXXXXXXXXXXXXXXXXXXXXXXXXXXXXXXXXXXXXXXXXXXXXXXXXXXXXXXXXXXXXXXXXXXXXXXXXXXXXXXXXXXXXXXXXXXXXXXXXXXXXXXXXXXXXXXXXXXXXXXXXXXXXXXXXXXXXXXXXXXXXXXXXXXXXXXXXXXXXXXXXXXXXXXXXXXXXXXXXXXXXXXXXXXXXXXXXXXXXXXXXXXXXXXXXXXXXXXXXXXXXXXXXXXXXXXXXXXXXXXXXXXXXXXXXXXXXXXXXXXXXXXXXXXXXXXXXXXXXXXXXXXXXXXXXXXXXXXXXXXXXXXXXXXXXXXXXXXXXXXXXXXXXXXXXXXXXXXXXXXXXXXXXXXXX
XXXXXXXXXXXXXXXXXXXXXXXXXXXXXXXXXXXXXXXXXXXXXXXXXXXXXXXXXXXXXXXXXXXXXXXXXXXXXXXXXXXXXXXXXXXXXXXXXXXXXXXXXXXXXXXXXXXXXXXXXXXXXXXXXXXXXXXXXXXXXXXXXXXXXXXXXXXXXXXXXXXXXXXXXXXXXXXXXXXXXXXXXXXXXXXXXXXXXXXXXXXXXXXXXXXXXXXXXXXXXXXXXXXXXXXXXXXXXXXXXXXXXXXXXXXXXXXXXXXXXXXXXXXXXXXXXXXXXXXXXXXXXXXXXXXXXXXXXXXXXXXXXXXXXXXXXXXXXXXXXXXXXXXXXXXXXXXXXXXXXXXXXXXXXXXXXXXXXXXXXXXXXXXXXXXXXXXXXXX
XXXXXXXXXXXXXXXXXXXXXXXXXXXXXXXXXXXXXXXXXXXXXXXXXXXXXXXXXXXXXXXXXXXXXXXXXXXXXXXXXXXXXXXXXXXXXXXXXXXXXXXXXXXXXXXXXXXXXXXXXXXXXXXXXXXXXXXXXXXXXXXXXXXXXXXXXXXXXXXXXXXXXXXXXXXXXXXXXXXXXXXXXXXXXXXXXXXXXXXXXXXXXXXXXXXXXXXXXXXXXXXXXXXXXXXXXXXXXXXXXXXXXXXXXXXXXXXXXXXXXXXXXXXXXXXXXXXXXXXXXXXXXXXXXXXXXXXXXXXXXXXXXXXXXXXXXXXXXXXXXXXXXXXXXXXXXXXXXXXXXXXXXXXXXXXXXXXXXXXXXXXXXXXXXXXXXXXXXXX
